#####################
#S..#.............#..#
#.#.#.###########.#.##
#.#...#.........#.#..#
#.#####.#######.#.##.#
#.....#.....#...#....#
###.#.#####.#.#######E
#...#.......#.........#
#####################