#####################
#S....#.............#
###.#.#.###########.#
#...#.#.....#.......#
#.###.#####.#.#####.#
#.....#.....#...#...#
#.#####.#######.#.###
#.......#.......#...#
#.#######.#####.###E#
#####################


