#########################
#S....#.................#
#.###.#.###.#.#########.#
#...#...#...#.....#.....#
###.#####.#######.#.###.#
#...#.....#.....#.#...#.#
#.###.#####.###.#.###.#.#
#.#...#.....#...#...#...#
#.#.###.#####.#####.###.#
#.#.....#.....#.....#...#
#.#######.###.#.#####.#.#
#.........#...#.......#E#
#########################
