#############################
#S..........................#
#####.#######.#.#############
#.....#.......#.....#.......#
#.#####.#############.#.###.#
#.....#...............#...#.#
#####.#.#################.#.#
#.....#.................#.#.#
#.###.#.###############.#.#.#
#...#.#.....#...........#...#
#.###.#####.#.###############
#.....#.....#..............E#
#############################
