##########################
#S..#........#..........##
#.#.#.######.#.#.######.##
#.#...#....#.#.#......#.##
#.#####.##.#.#.#.####.#.##
#.....#..#.#...#.#..#.#.##
###.#.##.#.#####.#.##.#.##
#...#....#............#.##
#.###########.#.#.########
#.............#.#.......E#
##########################
