#################################
#S.............#...............#
#.############.#.#############.#
#.#..........#.#.#...........#.#
#.#.########.#.#.#.#########.#.#
#.#.#......#.#.#.#.#.......#.#.#
#.#.#.####.#.#.#.#.#.#####.#.#.#
#.#.#.#..#.#.#.#.#.#.#...#.#.#.#
#.#.#.#..#.#.#.#.#.#.#.#.#.#.#.#
#.#.#.####.#.#.#.#.#.#.#.#.#.#.#
#.#.#......#.#.#.#.#.#.#.#.#.#.#
#.#.########.#.#.#.#.#.#.#.#.#.#
#.#..........#...#...#...#...#.#
#.#############################.#
#..............................E#
#################################
