#########################
#S#.....#...............#
#.#.###.#.#####.#.#####.#
#.#...#.#.....#.#.....#.#
#.###.#.#####.#.#####.#.#
#...#.#.....#.#.....#.#.#
###.#.#####.#.#####.#.#.#
#...#.....#.#.....#.#...#
#.#######.#.#####.#.###.#
#.......#.#.....#.#...#.#
#.#####.#.#####.#.###.#.#
#.....#.#.....#.#.....#.#
#.###.#.#####.#.#####.#.#
#...#.........#.......#E#
#########################
