######################
#S....#.............##
#.##.###.#####.#.###.#
#..#.....#.....#...#.#
##.#####.#.#####.###.#
#.....#..#.....#.....#
#.###.#.#######.####E#
#...#.#.............##
######################

